1111111111111111111111111111
1000010010000000000000000011
1011010010000000000100010111
1001001000000000011100111111
1011011010010000000CC0010111
10P00000010010C0000000000011
1011100010010000000000E01101
10C00010010000000000C0000111
1111111111111111111111111111