111111111111111111111111111
100000P00000000100000000011
100000000000000000C0000C011
100000C00000011110C11111C01
1000000000000000C00000C0001
111111100000011111110000011
111111111110100000011110111
1E00000000000C0000000000001
111111111111111111111111111